1111111111111111111111111111111111111111111111111
1111111111111111111111111111111111111111111111111
1111111111111111111111111111111111111111111111111
1111130111111111111111011111111111000011111111111
1111133111111111111111000111111110000001111111111
1111330111111111111111101111111111111000011111111
1111176011111111111111111111111111111111111111111
1111111111111113111111111111111111111111111111111
1111300111111113011111111111111113031111111111111
1111130011111110011111131111111100011111111111111
1111111011111110111111133111111101111111111111111
1111111111111111111111113111111131111111100111111
1111111111111111311111111111111111111111000111111
1111333111111110001111111111111111111111131111111
1111330111111111300111111111110111111111111111111
1111111111111111101111111111130003111111111111111
1111111111111111111111111111111331111111111111111
1111111111111130111111111111111111111111111111111
1111111111110000311111111111111111111111111111111
1111111111111130011111111111140011111111111111111
1111111111111111111111111111008011111111111111111
1111111111111111111111111111011111111111111111111
1111111111111111111111111111111111111111111111111
1111111111111111111111111111111111111111111111111
1111111111111111111111111111111111111111111111111
1111111111111111111111111111111111111111111111111
1111111111111111111111111111111111111111111111111
