1111111111111111111111111111111111111111111111111
1111111111111111111111111111111111111111111111111
1113333111111111100033311111111111111111111111111
1113333001110010000003333331111100001111111111111
1133300000000000000000000111000011000011111111111
1110000000000000000673330010000000001111111111111
1111111100000000000333111111001111111111111111111
1111111111133000000003311000000000001111111111111
1111111111131100000000031110000000000011111111111
1111111111100000000000011000000300011111111111111
1111111110000000000111110000033331111111111111111
1111111111113300001100000003333333333111111111111
1111111111111301111000111000333311111111111111111
1111111111111111000000000333331111111111111111111
1111111111110000001100001113333311000111111111111
1111111111110000000000001111111111100001101111111
1111111111111111110000000001111111100800011111111
1111111111111111110100000111111111000110111111111
1111111111111100001111111111111111110010000111111
1111111111110000000111111111111111110001111111111
1111111111111100000111111111111111111011111111111
1111111111111111110000111111111111111111111111111
1111111111111111111100011111111111111111111111111
1111111111111111111111110111111111111111111111111
1111111111111111111111111111111111111111111111111
1111111111111111111111111111111111111111111111111
1111111111111111111111111111111111111111111111111