1111111111111111111111111111111111111111111111111
1111111111111111111111111111111111111111111111111
1111111111111111111111111111111111111111111111111
1111111111111111111111111111111111111111111111111
1111111111111111111111300000000111111111111111111
1111111111111111133333000000001111111111111111111
1111111111111111333730000000031111111111111111111
1111111111111113300063000000033311111111111111111
1111111111113330003030030000000331111111111111111
1111111111133000000000000000000000111111111111111
1111111111111000000000030000007331111111111111111
1111111111130000000030000000031111111111111111111
1111111111111111333300000000000000001111111111111
1111111111111111111100018000000000111111111111111
1111111111111111111111111000000011111111111111111
1111111111111111111111111111111111111111111111111
1111111111111111111111111111111111111111111111111
1111111111111111111111111111111111111111111111111
1111111111111111111111111111111111111111111111111
1111111111111111111111111111111111111111111111111
1111111111111111111111111111111111111111111111111
1111111111111111111111111111111111111111111111111
1111111111111111111111111111111111111111111111111
1111111111111111111111111111111111111111111111111
1111111111111111111111111111111111111111111111111
1111111111111111111111111111111111111111111111111
1111111111111111111111111111111111111111111111111